NO ./mandatory/assets/textures/north.xpm
SO ./mandatory/assets/textures/south.xpm
WE ./mandatory/assets/textures/west.xpm
EA ./mandatory/assets/textures/east.xpm

F 64,64,64,0
C 128,128,128,0


        1111111111111111111111111
        1000000000110000000000001
        101100000111000000000001
        1001000000000N0000000001
111111111011000001110000000000001
110000000001100000111010011111111
11110111111111010000000100001
11110111111111010101010000001
10000000110101010100000000001
10110000000000100011000000101
11000000000000011010100000111
11000001110101011111011110001
11110111111010110111101000001
11110111111010110111101000001
11111111111111111111111100011
11111111111111111111111111111
   