NO ./mandatory/assets/textures/north.xpm
SO ./mandatory/assets/textures/south.xpm
WE ./mandatory/assets/textures/tardis.xpm
EA ./mandatory/assets/textures/east.xpm

F 64,64,64,0
C 128,128,128,0

1111111111111111
100000000000000E1
10000000000000001
10000000000000001
10000000000000001
10000000000000001
10000000000000001
11111111111111111
   


