NO ./bonus/assets/textures/north.xpm
SO ./bonus/assets/textures/south.xpm
WE ./bonus/assets/textures/west.xpm
EA ./bonus/assets/textures/east.xpm

F 64,64,64
C 128,128,128

111111111
100000001
100000N01
111111111
